	20
15
00000000000000000000
01111111111111111110
01111111111111111110
01111111111111111110
01111111111111111110
01111111111111111110
01111111111111111110
01111111111111111100
00111111111111110000
00111111111111000000
00000111111100000000
00000000000000000000
00000000000000000000